"Account Name : Primary checking"
"Account Number : 123456789A00"
"Date Range : 10/09/2023-01/07/2024"
Transaction Number,Date,Description,Memo,Amount Debit,Amount Credit,Balance,Check Number,Fees  
"20240102000000[-6:CST]*1.37*504**FIRST COMMUNITY",01/02/2024,"FIRST COMMUNITY","-RDC DEP : Deposit",,1.37,"1056.28",,
"20240107000000[-6:CST]*-59.37*13**CHICK-FIL-A #05060",01/07/2024,"CHICK-FIL-A #05060","618-391-0563 ILUS : POS Transaction",-59.37,,"1054.91",,
"20240107000000[-6:CST]*-10.79*13**CHICK-FIL-A #05060",01/07/2024,"CHICK-FIL-A #05060","618-391-0563 ILUS : POS Transaction",-10.79,,"1114.28",,
"20240106000000[-6:CST]*-19.99*13**DOLLAR-GENERAL DG 01053311",01/06/2024,"DOLLAR-GENERAL DG 01053311","RIGGIN RD TROY ILUS : POS Transaction",-19.99,,"1125.07",,
"20240106000000[-6:CST]*-9.40*13**ANNIES FROZEN CUSTARD GLEN",01/06/2024,"ANNIES FROZEN CUSTARD GLEN","CARBON ILUS : POS Transaction",-9.40,,"1145.06",,
"20240106000000[-6:CST]*-40.00*13**FRYE FUNCTIONAL HEAL",01/06/2024,"FRYE FUNCTIONAL HEAL","618-6921800 ILUS : POS Transaction",-40.00,,"1154.46",,
"20240105000000[-6:CST]*-22.94*13**CASEYS #3336 440 EDWARDTROY",01/05/2024,"CASEYS #3336 440 EDWARDTROY","ILUS : POS Transaction",-22.94,,"1194.46",,
"20240105000000[-6:CST]*-173.72*0**SCHOOL -",01/05/2024,"SCHOOL -","- TUITION : ACH Withdrawal",-173.72,,"1217.40",,